22222222222222222222
22222222222222222222
22222222222222222222
22222212222222222222
22222222222211222222
22222222212212222222
22222221111111222222
22222212111111222222
22222111111111122222
22221111111111112222
22222111111211122222
22222211111111222222
22222211222122222222
22222222222222212222
22222122222222222222
22222222222222222222
22222222222122222222
22222222222222222222
22222222222222222222
22222222222222222222
