11111111111111111111
11111111111111111111
11111111111111111111
11111111111111111111
11111111111111111111
11111111131311111111
11111111313131111111
11111113131313111111
11111131313131311111
11111313131313131111
11111131313131311111
11111113131313111111
11111111313131111111
11111111131311111111
11111111111111111111
11111111111111111111
11111111111111111111
11111111111111111111
11111111111111111111
11111111111111111111